500 500
37 31
backgrounds/bg_desert.xml
19  4  2  4  2  4  2  4  2  4  2  4  2  4  2 13 17 17 17 17 17 17 17 17 17 17 17 17 17 17 17 17 17 17 23 17 17
23  3  3  3  3  3  3  3  3  3  3  3  3  3  3 13 17 17 17 17 17  2  4  2  4  2  4  2  4  2  4 17 17 17 22 17 17
22 -1 -1 -1 -1 -1 -1 -1 -1 -1 -1 -1 -1 -1 -1 17 17 17 17 17  4  7  5  7  5  7  5  7  5  7  5  2  4 17 23 17 17
23 -1 -1 -1 -1 -1 -1 -1 -1 -1 -1 -1 -1 -1 -1 13 17 17 17  4  5 -1 -1 -1 -1 -1 -1 -1 -1 -1 -1  3  5  4 22 17 17
24 -1 -1 -1 -1 -1 2 -1 -1 2 -1 -1 -1 -1 -1   13 17 17  8  3 -1 -1 -1 -1 -1 -1 -1 -1 -1 -1 -1 -1 -1  5 23 17 17
22 -1 -1 -1 -1 2 -1 -1 -1 -1 2 -1 -1 -1 -1    4  6  8  5 -1 -1 -1 -1 -1 -1 -1 -1 -1 -1 -1 -1 -1 -1 -1 22 17 17
24 -1 -1 -1 2 -1 -1 -1 -1 -1 -1 2 -1 -1 -1    3  5  3 -1 -1 -1 -1 -1 -1 -1 -1 -1 -1 -1 -1 -1 -1 -1 -1 23 17 17
22 -1 -1 -1 -1 -1 -1 -1 -1 -1 -1 -1 -1 -1 -1 -1 -1 -1 -1 -1 -1 -1 -1 -1 -1 -1 -1 -1 -1 -1 -1 -1 -1 -1 22 17 17
23 -1 -1 -1 -1 -1 -1 -1 -1 -1 -1 -1 -1 -1 -1 -1 -1 -1 -1 -1 -1 -1 -1 -1 -1 -1 -1 -1 -1 -1 -1 -1 -1 -1 23 17 17 
23 -1 -1 -1 2 -1 -1 -1 -1 -1 -1 2 -1 -1 -1   17 17 17 21 -1 -1 -1 -1 -1 -1 -1 -1 -1 -1 -1 -1 -1 -1 -1 23 17 17
22 -1 -1 -1 -1 2 -1 -1 -1 -1 2 -1 -1 -1  -1  14 17 17 17 21 -1 -1 -1 -1 -1 -1 -1 -1 -1 -1 -1 -1 -1 -1 22 17 17
24 -1 -1 -1 -1 -1 2 -1 -1 2 -1 -1 -1 -1 -1   17 17 17 17 17 21 -1 -1 -1 -1 -1 -1 -1 17 -1 17 -1 -1 -1 22 17 17
23 -1 -1 -1 -1 -1 -1 -1 -1 -1 -1 -1 -1 -1 -1 13 17 17 17 17 17 -1 -1 -1 -1 -1 -1 17 -1 -1 -1 17 -1 -1 23 17 17
24 -1 -1 -1 -1 -1 -1 -1 -1 -1 -1 -1 -1 -1 -1 17 17 17 17 17 17 21 -1 -1 -1 -1 17 -1 -1 -1 -1 -1 17 17 17 17 17
22 -1 -1 -1 -1 -1 -1 -1 -1 -1 -1 -1 -1 -1 -1 14 17 17 17 17 17 17 21 -1 -1 17 -1 -1 -1 -1 -1 -1 -1 -1 -1 -1 17
19 16 16 16 16 16 16 16 16 16 16 16 16 16 16 19 17 17 17 17 17 17 17 17 17 17 17 17 17 17 17 17 17 21 -1 -1 17
19 16 16 16 16 16 16 16 16 16 16 16 16 16 16 19 17 17 17 17 17 17 17 17 17 17 17 17 17 17 17 17 17 17 -1 -1 17
19 16 16 16 16 16 16 16 16 16 16 16 16 16 16 19 17 17 17 17 17 17 17 17 17 17 17 17 17 17 17 17 17  4 -1 -1 17
17  4  2  4  2  4  2  4  2  4  2  4  2  4  2  4  4  2  2 17 17 17 17 17 17 17 17 17 17 17 17  2  4  5 -1 -1 17
17  3  5  7  3  5  7  3  5  7  3  5  7  3  5  7  3  5  7 17  4  2  4 17  4  2 17  4  6 17  4  7  3 -1 -1 -1 17
17 -1 -1 -1 -1 -1 -1 -1 -1 -1 -1 -1 -1 -1 -1 -1 -1 -1 -1 17  3  3  5  2  5  5  2  3  7  2  5 -1 -1 -1 -1 -1 17
17 -1 -1  2 -1 -1 -1 -1 -1  4 -1 -1 -1 -1 -1 -1 -1 17 -1 17 -1 -1 -1  3 -1 -1  3 -1 -1  3 -1 -1 -1 -1 -1 -1 17
17 -1 -1  7 -1 -1 -1 -1 -1  5 -1 -1 -1 -1 -1 -1 -1 17 -1 17 -1 -1 -1 -1 -1 -1 -1 -1 -1 -1 -1 -1 -1 -1 -1 -1 17
17 -1 -1 -1 -1 -1 -1 -1 -1 -1 -1 -1 -1 -1 -1 -1 -1 17 -1 17 -1 -1 -1 -1 -1 -1 -1 -1 -1 -1 -1 -1 -1 -1 -1 -1 17
17 -1 -1 -1 -1 -1 -1 -1 -1 -1 -1 -1 -1 -1 -1 -1 -1 17 -1 17 -1 -1 -1 -1 -1 -1 -1 -1 -1 -1 -1 -1 -1 -1 -1 -1 17
17 -1 -1  2 -1 -1 -1 -1 -1  4 -1 -1 -1 -1 -1 -1 -1 17 -1 17 -1 -1 -1 -1 -1 -1 -1 -1 -1 -1 -1 -1 -1 -1 -1 -1 17
17 -1 -1  7 -1 -1 -1 -1 -1  5 -1 -1 -1 -1 -1 -1 -1 17 -1 17 -1 -1 -1 -1 -1 -1 -1 -1 -1 -1 -1 -1 -1 -1 -1 -1 17
17 -1 -1 -1 -1 -1 -1 -1 -1 -1 -1 -1 -1 -1 -1 -1 -1 17 -1 17 -1 -1 -1 -1 -1 -1 -1 -1 -1 -1 -1 -1 -1 -1 -1 -1 17
17 -1 -1 -1 -1 -1 -1 -1 -1 -1 -1 -1 -1 -1 -1 -1 -1 17 -1 -1 -1 -1 -1 -1 -1 -1 -1 -1 -1 -1 -1 -1 -1 -1 -1 -1 17
17 -1 -1 -1 -1 -1 -1 -1 -1 -1 -1 -1 -1 -1 -1 -1 -1 17 17 17 -1 -1 -1 -1 -1 -1 -1 -1 -1 -1 -1 -1 -1 -1 -1 -1 17
17 17 17 17 17 17 17 17 17 17 17 17 17 17 17 17 17 17 23 17 17 17 17 17 17 17 17 17 17 17 17 17 17 17 17 17 17
