45 695
56 22
backgrounds/bg_ship.xml
24 24 24 24 24 24 24 24 24 24 24 24 24 24 24 24 24 24 24 24 24 24 24 24 24 24 24 24 24 24 24 24 24 24 24 24 24 24 24 24 24 24 24 24 24 24 24 24 24 24 24 24 24 24 24 24
24 24 24 24 24 24 24 24 24 24 24 24 24 24 24 24 24 24 24 24 24 24 24 24 24 24 24 24 24 24 24 24 24 24 24 24 24 24 24 24 24 24 24 24 24 24 24 24 24 24 24 24 24 24 24 24
24 24 24 24 24 24 24 24 24 24 24 24 24 24 -1 -1 -1 -1 -1 -1 -1 -1 -1 -1 -1 -1 -1 -1 -1 -1 -1 -1 24 24 24 24 24 24 24 -1 -1 -1 -1 -1 -1 -1 -1 -1 -1 -1 -1 -1 -1 -1 -1 -1
24 24 -1 -1 -1 -1 -1 -1 24 24 24 24 24 24 -1 -1 -1 -1 -1 -1 -1 -1 -1 -1 -1 -1 -1 -1 -1 -1 -1 -1 24 24 24 24 24 1 1 -1 -1 -1 -1 -1 -1 -1 -1 -1 -1 -1 -1 -1 -1 -1 -1 -1
24 24 -1 -1 -1 -1 -1 -1 24 24 24 24 24 24 -1 -1 24 24 24 24 24 24 24 24 -1 -1 24 24 24 24 -1 -1 0 2 2 2 1 -1 -1 -1 -1 24 24 24 24 24 -1 -1 24 24 24 24 24 -1 -1 24
24 24 -1 -1 24 24 -1 -1 24 24 24 24 24 24 -1 -1 24 24 24 24 24 24 24 24 -1 -1 24 24 24 24 -1 -1 -1 -1 -1 -1 -1 -1 -1 -1 -1 24 24 24 24 24 -1 -1 24 24 24 24 24 -1 -1 24
24 24 -1 -1 24 24 -1 -1 0 2 2 2 2 1 -1 -1 24 24 24 24 24 24 24 24 -1 -1 24 24 24 24 -1 -1 -1 -1 -1 -1 -1 -1 -1 24 24 24 24 24 24 24 -1 -1 24 24 24 24 24 -1 -1 24
24 24 -1 -1 24 24 -1 -1 -1 -1 -1 -1 -1 -1 -1 -1 24 24 24 24 24 24 24 24 -1 -1 24 24 24 24 -1 -1 24 24 24 24 24 -1 -1 24 24 24 24 24 24 24 -1 -1 24 24 24 24 24 -1 -1 24
24 24 -1 -1 24 24 -1 -1 -1 -1 -1 -1 -1 -1 -1 -1 24 24 24 24 24 24 24 24 -1 -1 24 24 24 24 -1 -1 24 24 24 24 24 -1 -1 24 24 24 24 24 24 24 -1 -1 24 24 24 24 24 -1 -1 24
24 24 -1 -1 0 1 -1 -1 24 24 24 24 24 24 24 24 24 24 24 24 24 24 24 24 -1 -1 24 24 24 24 -1 -1 24 24 24 24 24 -1 -1 24 24 24 24 2 2 1 -1 -1 24 24 24 24 24 -1 -1 24
-1 -1 -1 -1 -1 -1 -1 -1 24 24 24 24 24 24 24 24 24 24 -1 -1 24 24 24 24 -1 -1 24 24 24 24 -1 -1 24 24 24 24 24 -1 -1 24 24 24 24 -1 -1 -1 -1 -1 24 24 24 24 24 -1 -1 24
-1 -1 -1 -1 -1 -1 -1 -1 24 24 24 24 24 24 24 24 24 24 -1 -1 24 24 24 24 -1 -1 24 24 24 24 -1 -1 24 24 24 24 24 -1 -1 24 24 24 24 -1 -1 -1 -1 -1 24 24 24 24 24 -1 -1 24
24 -1 -1 24 24 24 -1 -1 24 24 24 24 24 24 24 24 24 24 -1 -1 24 24 24 24 -1 -1 24 24 24 24 -1 -1 24 24 24 24 24 -1 -1 24 24 24 24 -1 -1 24 24 24 24 24 24 24 24 -1 -1 24
24 -1 -1 24 24 24 -1 -1 24 24 24 24 24 24 24 24 24 24 -1 -1 24 24 24 24 -1 -1 0 2 2 1 -1 -1 24 24 24 24 24 -1 -1 24 24 24 24 -1 -1 24 24 24 24 24 24 24 24 -1 -1 24
24 -1 -1 24 24 24 -1 -1 24 24 24 24 24 24 24 24 24 24 -1 -1 24 24 24 24 -1 -1 -1 -1 -1 -1 -1 -1 24 24 24 24 24 -1 -1 24 24 24 24 -1 -1 24 24 24 24 24 24 24 24 -1 -1 24
24 -1 -1 24 24 24 -1 -1 0 24 24 24 24 24 24 24 24 24 -1 -1 0 2 2 1 -1 -1 -1 -1 -1 -1 -1 -1 24 24 24 24 24 -1 -1 0 2 2 1 -1 -1 24 24 24 24 24 24 24 24 -1 -1 24
24 -1 -1 24 24 24 -1 -1 -1 -1 -1 -1 -1 -1 -1 24 24 24 -1 -1 -1 -1 -1 -1 -1 -1 24 24 24 24 -1 -1 24 24 24 24 24 -1 -1 -1 -1 -1 -1 -1 -1 24 24 24 24 24 24 24 24 -1 -1 24
24 -1 -1 0 2 1 -1 -1 -1 -1 -1 -1 -1 -1 -1 24 24 24 -1 -1 -1 -1 -1 -1 -1 -1 24 24 24 24 -1 -1 24 24 24 24 24 -1 -1 -1 -1 -1 -1 -1 -1 0 2 2 2 2 2 2 1 -1 -1 24
24 -1 -1 -1 -1 -1 -1 -1 24 24 24 24 24 -1 -1 0 2 1 -1 -1 24 24 24 24 24 24 24 24 24 24 -1 -1 24 24 24 24 24 24 24 24 24 24 24 -1 -1 -1 -1 -1 -1 -1 -1 -1 -1 -1 -1 24
24 -1 -1 -1 -1 -1 -1 -1 24 24 24 24 24 -1 -1 -1 -1 -1 -1 -1 24 24 24 24 24 24 24 24 24 24 -1 -1 24 24 24 24 24 24 24 24 24 24 24 -1 -1 -1 -1 -1 -1 -1 -1 -1 -1 -1 -1 24
24 24 24 24 24 24 24 24 24 24 24 24 24 -1 -1 -1 -1 -1 -1 -1 24 24 24 24 24 24 24 24 24 24 24 24 24 24 24 24 24 24 24 24 24 24 24 24 24 24 24 24 24 24 24 24 -1 -1 24 24
24 24 24 24 24 24 24 24 24 24 24 24 24 24 24 24 24 24 24 24 24 24 24 24 24 24 24 24 24 24 24 24 24 24 24 24 24 24 24 24 24 24 24 24 24 24 24 24 24 24 24 24 -1 -1 24 24
